     1  7    8
     2  1    4
     3  5    4
     4  4    2
     5  1    1
     6  6    6
     7  3    5
     8  2    3
     9  6    3
    10  0    7
    11  4    7
    12  7    5
    13  1    4
    14  5    1
    15  3    8
    16  2    6
    17  6    6
    18  0    2
    19  4    2
    20  7    8
    21  0    7
    22  5    4
    23  2    3
    24  1    1
    25  5    1
    26  3    5
    27  7    5
    28  6    3
    29  0    2
    30  4    7
    31  2    6
    32  1    4
    33  5    4
    34  3    8
    35  7    8
    36  6    6
    37  3    5
    38  4    2
    39  1    1
    40  0    7
    41  4    7
    42  2    3
    43  6    3
    44  5    1
    45  3    8
    46  7    5
    47  1    4
    48  0    2
    49  4    2
    50  2    6
    51  6    6
    52  5    4
    53  2    3
    54  7    8
    55  0    7
    56  3    5
    57  7    5
    58  1    1
    59  5    1
    60  4    7
    61  2    6
    62  6    3
    63  0    2
    64  3    8
    65  7    8
    66  1    4
    67  5    4
    68  4    2
    69  1    1
    70  6    6
